{
  "number": 50,
  "row": 8,
  "col": 8,
  "color": 5,
  "level": [
    [0, 0, 0, 0, 0, 0, 0, 0],
    [0, 0, 0, 0, 0, 0, 0, 0],
    [0, 0, 0, 0, 0, 0, 0, 0],
    [0, 0, 128, 0, 0, 128, 0, 0],
    [0, 128, 128, 0, 0, 128, 128, 0],
    [128, 128, 128, 0, 0, 128, 128, 128],
    [128, 128, 0, 0, 0, 0, 128, 128],
    [128, 0, 0, 0, 0, 0, 0, 128]
  ],
  "boards": [
    [1, 1, 1, 1, 1, 1, 1, 1],
    [1, 1, 1, 1, 1, 1, 1, 1],
    [1, 1, 1, 0, 0, 1, 1, 1],
    [1, 1, 0, 0, 0, 0, 1, 1],
    [1, 0, 0, 0, 0, 0, 0, 1],
    [0, 0, 0, 0, 0, 0, 0, 0],
    [0, 0, 0, 0, 0, 0, 0, 0],
    [0, 0, 0, 0, 0, 0, 0, 0]
  ],
  "goals": {
"ice": 18,
"board": 28
  }
}
