{ 
  "points": 30,
  "pointsIce": 1000,
  "pointsSpider": 1000,
  "pointsStone": 1000,
  "pointsBoard": 1000,
  "pointsAcorn": 1000,
  "pointsUnspentStep": 3000, 
  "number": 35,
  "row": 8,
  "col": 8,
  "color": 6,
  "level": [
    [0, 512, 0, 0, 0, 0, 512, 0],
    [0, 512, 0, 0, 0, 0, 512, 0],
    [0, 0, 0, 0, 0, 0, 0, 0],
    [0, 0, 0, 0, 0, 0, 0, 0],
    [0, 0, 0, 0, 0, 0, 0, 0],
    [0, 0, 0, 0, 0, 0, 0, 0],
    [512, 0, 0, 0, 0, 0, 0, 512],
    [512, 512, 0, 0, 0, 0, 512, 512]
  ],
  "boards": [
    [1, 1, 1, 1, 1, 1, 1, 1],
    [1, 1, 1, 1, 1, 1, 1, 1],
    [1, 1, 1, 1, 1, 1, 1, 1],
    [1, 1, 1, 1, 1, 1, 1, 1],
    [1, 1, 1, 1, 1, 1, 1, 1],
    [1, 1, 1, 1, 1, 1, 1, 1],
    [1, 1, 1, 1, 1, 1, 1, 1],
    [1, 1, 1, 1, 1, 1, 1, 1]
  ],
  "spider": [
    [2, 3],
    [3, 4]

],
  "goals": {
"3": 24,
"4": 12
  }
}
