{
  "number": 42,
  "row": 8,
  "col": 8,
  "color": 5,
  "level": [
    [0, 0, 128, 0, 0, 128, 0, 0],
    [0, 0, 128, 0, 0, 128, 0, 0],
    [512, 512, 128, 0, 0, 128, 512, 512],
    [512, 512, 128, 0, 0, 128, 512, 512],
    [512, 0, 128, 0, 0, 128, 0, 512],
    [512, 0, 128, 0, 0, 128, 0, 512],
    [512, 0, 128, 0, 0, 128, 0, 512],
    [512, 0, 128, 0, 0, 128, 0, 512]
  ],
  "boards": [
    [1, 1, 1, 1, 1, 1, 1, 1],
    [1, 1, 1, 1, 1, 1, 1, 1],
    [0, 0, 1, 1, 1, 1, 0, 0],
    [0, 0, 1, 1, 1, 1, 0, 0],
    [0, 1, 1, 1, 1, 1, 1, 0],
    [0, 1, 1, 1, 1, 1, 1, 0],
    [0, 1, 1, 1, 1, 1, 1, 0],
    [0, 1, 1, 1, 1, 1, 1, 0]
  ],
  "goals": {
"board": 48,
"ice": 16
  }
}
