{
  "number": 41,
  "row": 8,
  "col": 8,
  "color": 5,
  "level": [
    [0, 0, 128, 0, 0, 128, 0, 0],
    [0, 0, 128, 0, 0, 128, 0, 0],
    [0, 0, 128, 0, 0, 128, 0, 0],
    [0, 0, 128, 0, 0, 128, 0, 0],
    [0, 0, 128, 128, 128, 128, 0, 0],
    [128, 128, 128, 0, 0, 128, 128, 128],
    [0, 0, 128, 128, 128, 128, 0, 0],
    [512, 512, 512, 512, 512, 512, 512, 512]
  ],
  "boards": [
    [0, 0, 0, 0, 0, 0, 0, 0],
    [0, 0, 0, 0, 0, 0, 0, 0],
    [0, 0, 0, 0, 0, 0, 0, 0],
    [0, 0, 0, 0, 0, 0, 0, 0],
    [0, 0, 0, 0, 0, 0, 0, 0],
    [0, 0, 0, 0, 0, 0, 0, 0],
    [0, 0, 0, 0, 0, 0, 0, 0],
    [0, 0, 0, 0, 0, 0, 0, 0]
  ],
  "goals": {
"ice": 22
  }
}
