{
  "number": 3,
  "row": 8,
  "col": 8,
  "color": 6,
  "level": [
    [512, 0, 0, 0, 0, 0, 512, 512],
    [0, 0, 512, 512, 0, 0, 0, 512],
    [0, 512, 0, 0, 512, 0, 0, 0],
    [0, 0, 0, 0, 0, 0, 0, 0],
    [0, 0, 0, 0, 0, 0, 0, 0],
    [0, 0, 0, 512, 0, 0, 512, 0],
    [512, 0, 0, 0, 512, 512, 0, 0],
    [512, 512, 0, 0, 0, 0, 0, 512]
  ],
  "boards": [
    [0, 0, 0, 0, 0, 0, 0, 0],
    [0, 0, 0, 0, 0, 0, 0, 0],
    [0, 0, 0, 0, 0, 0, 0, 0],
    [0, 0, 0, 0, 0, 0, 0, 0],
    [0, 0, 0, 0, 0, 0, 0, 0],
    [0, 0, 0, 0, 0, 0, 0, 0],
    [0, 0, 0, 0, 0, 0, 0, 0],
    [0, 0, 0, 0, 0, 0, 0, 0]
  ],
  "goals": {
"4": 24,
"2": 12
}
}
