{
  "number": 24,
  "row": 8,
  "col": 8,
  "color": 5,
  "level": [
    [0, 0, 0, 0, 0, 0, 0, 0],
    [0, 256, 256, 256, 256, 256, 256, 0],
    [0, 256, 0, 0, 0, 0, 256, 0],
    [0, 256, 0, 15, 15, 0, 256, 0],
    [0, 256, 0, 15, 15, 0, 256, 0],
    [0, 256, 0, 0, 0, 0, 256, 0],
    [0, 256, 256, 256, 256, 256, 256, 0],
    [0, 0, 0, 0, 0, 0, 0, 0]
  ],
  "boards": [
    [1, 1, 1, 1, 1, 1, 1, 1],
    [1, 0, 0, 0, 0, 0, 0, 1],
    [1, 0, 1, 1, 1, 1, 0, 1],
    [1, 0, 1, 1, 1, 1, 0, 1],
    [1, 0, 1, 1, 1, 1, 0, 1],
    [1, 0, 1, 1, 1, 1, 0, 1],
    [1, 0, 0, 0, 0, 0, 0, 1],
    [1, 1, 1, 1, 1, 1, 1, 1]
  ],
  "goals": {
"boards": 44
  }
}
