{
  "number": 54,
  "row": 8,
  "col": 8,
  "color": 5,
  "level": [
    [0, 0, 0, 0, 0, 0, 0, 0],
    [128, 128, 0, 0, 0, 0, 128, 128],
    [128, 128, 0, 128, 128, 0, 128, 128],
    [0, 128, 128, 128, 128, 128, 128, 0],
    [0, 128, 128, 0, 0, 128, 128, 0],
    [512, 512, 512, 512, 512, 512, 512, 512],
    [512, 512, 512, 512, 512, 512, 512, 512],
    [512, 512, 512, 512, 512, 512, 512, 512]
  ],
  "boards": [
    [1, 1, 1, 1, 1, 1, 1, 1],
    [1, 1, 1, 1, 1, 1, 1, 1],
    [1, 1, 1, 1, 1, 1, 1, 1],
    [1, 1, 1, 1, 1, 1, 1, 1],
    [1, 1, 1, 1, 1, 1, 1, 1],
    [0, 0, 0, 0, 0, 0, 0, 0],
    [0, 0, 0, 0, 0, 0, 0, 0],
    [0, 0, 0, 0, 0, 0, 0, 0]
  ],
  "goals": {
"board": 40,
"ice": 20
  }
}
