{
  "number": 7,
  "row": 8,
  "col": 8,
  "color": 5,
  "level": [
    [512, 512, 0, 512, 512, 0, 512, 512],
    [512, 512, 0, 512, 512, 0, 512, 512],
    [512, 512, 0, 512, 512, 0, 512, 512],
    [512, 512, 0, 512, 512, 0, 512, 512],
    [512, 0, 0, 0, 0, 0, 0, 512],
    [0, 0, 0, 0, 0, 0, 0, 0],
    [0, 0, 0, 0, 0, 0, 0, 0],
    [0, 0, 0, 0, 0, 0, 0, 0]
  ],
  "boards": [
    [0, 0, 0, 0, 0, 0, 0, 0],
    [0, 0, 0, 0, 0, 0, 0, 0],
    [0, 0, 0, 0, 0, 0, 0, 0],
    [0, 0, 0, 0, 0, 0, 0, 0],
    [0, 0, 0, 0, 0, 0, 0, 0],
    [0, 0, 0, 0, 0, 0, 0, 0],
    [0, 0, 0, 0, 0, 0, 0, 0],
    [0, 0, 0, 0, 0, 0, 0, 0]
  ],
  "goals": {
"4": 24,
"2": 12
}

}
