{
  "number": 49,
  "row": 8,
  "col": 8,
  "color": 5,
  "level": [
    [0, 0, 0, 0, 0, 0, 0, 0],
    [0, 0, 0, 0, 0, 0, 0, 0],
    [0, 0, 0, 0, 0, 0, 0, 0],
    [128, 128, 128, 0, 0, 128, 128, 128],
    [128, 0, 128, 0, 0, 128, 0, 128],
    [128, 128, 128, 0, 0, 128, 128, 128],
    [512, 512, 512, 512, 512, 512, 512, 512],
    [512, 512, 512, 512, 512, 512, 512, 512]
  ],
  "boards": [
    [0, 0, 0, 0, 0, 0, 0, 0],
    [0, 0, 0, 0, 0, 0, 0, 0],
    [0, 0, 0, 0, 0, 0, 0, 0],
    [0, 0, 0, 0, 0, 0, 0, 0],
    [0, 0, 0, 0, 0, 0, 0, 0],
    [0, 0, 0, 0, 0, 0, 0, 0],
    [0, 0, 0, 0, 0, 0, 0, 0],
    [0, 0, 0, 0, 0, 0, 0, 0]
  ],
  "spider": [
[4, 1],
[4, 6]
],
  "goals": {
"ice": 16,
"web": 2
  }
  
}
