{ 
  "points": 30,
  "pointsIce": 1000,
  "pointsSpider": 1000,
  "pointsStone": 1000,
  "pointsBoard": 1000,
  "pointsAcorn": 1000,
  "pointsUnspentStep": 3000, 
  "number": 36,
  "row": 8,
  "col": 8,
  "color": 6,
  "level": [
    [512, 0, 0, 0, 0, 0, 0, 512],
    [512, 0, 0, 0, 0, 0, 0, 512],
    [512, 0, 0, 0, 0, 0, 0, 512],
    [512, 0, 0, 15, 15, 0, 0, 512],
    [512, 0, 0, 15, 15, 0, 0, 512],
    [512, 0, 0, 15, 15, 0, 0, 512],
    [512, 15, 15, 15, 15, 15, 15, 512],
    [512, 15, 15, 15, 15, 15, 15, 512]
  ],
  "boards": [
    [0, 1, 1, 1, 1, 1, 1, 0],
    [0, 1, 1, 1, 1, 1, 1, 0],
    [0, 1, 1, 1, 1, 1, 1, 0],
    [0, 1, 1, 1, 1, 1, 1, 0],
    [0, 1, 1, 1, 1, 1, 1, 0],
    [0, 1, 1, 1, 1, 1, 1, 0],
    [0, 1, 1, 1, 1, 1, 1, 0],
    [0, 1, 1, 1, 1, 1, 1, 0]
  ],
  "goals": {
"board": 48
  }
}
