{
  "number": 22,
  "row": 8,
  "col": 8,
  "color": 5,
  "level": [
    [512, 0, 0, 0, 0, 0, 0, 512],
    [512, 0, 0, 0, 0, 0, 0, 512],
    [512, 0, 0, 0, 0, 0, 0, 512],
    [512, 0, 0, 0, 0, 0, 0, 512],
    [512, 256, 0, 0, 0, 0, 256, 512],
    [512, 256, 256, 0, 0, 256, 256, 512],
    [512, 256, 256, 256, 256, 256, 256, 512],
    [512, 0, 0, 0, 0, 0, 0, 512]
    
  ],
  "boards": [
    [0, 0, 0, 0, 0, 0, 0, 0],
    [0, 0, 0, 0, 0, 0, 0, 0],
    [0, 0, 0, 0, 0, 0, 0, 0],
    [0, 0, 0, 0, 0, 0, 0, 0],
    [0, 0, 0, 0, 0, 0, 0, 0],
    [0, 0, 0, 0, 0, 0, 0, 0],
    [0, 0, 0, 0, 0, 0, 0, 0],
    [0, 1, 1, 1, 1, 1, 1, 0]
  ],
  "goals": {
 "board": 6,
   "1" : 32
  }
}
