{ 
  "points": 30,
  "pointsIce": 1000,
  "pointsSpider": 1000,
  "pointsStone": 1000,
  "pointsBoard": 1000,
  "pointsAcorn": 1000,
  "pointsUnspentStep": 3000, 
  "number": 34,
  "row": 8,
  "col": 8,
  "color": 5,
  "level": [
    [0, 0, 0, 0, 0, 0, 0, 0],
    [0, 0, 0, 0, 0, 0, 0, 0],
    [0, 0, 0, 0, 0, 0, 0, 0],
    [0, 0, 0, 0, 0, 0, 0, 0],
    [0, 0, 0, 0, 0, 0, 0, 0],
    [0, 0, 0, 0, 0, 0, 0, 0],
    [0, 0, 0, 0, 0, 0, 0, 0],
    [0, 0, 0, 0, 0, 0, 0, 0]
  ],
  "boards": [
    [1, 1, 1, 1, 1, 1, 1, 1],
    [1, 0, 1, 1, 1, 1, 0, 1],
    [1, 1, 1, 1, 1, 1, 1, 1],
    [1, 1, 1, 1, 1, 1, 1, 1],
    [1, 1, 1, 1, 1, 1, 1, 1],
    [1, 1, 1, 1, 1, 1, 1, 1],
    [1, 0, 1, 1, 1, 1, 0, 1],
    [1, 1, 1, 1, 1, 1, 1, 1]
  ],
  "spider": [
    [1, 1],
    [1, 6],
    [6, 1],
    [6, 6]

],
  "goals": {
"board": 60
  }
}
