{
  "number": 53,
  "row": 8,
  "col": 8,
  "color": 5,
  "level": [
    [128, 256, 128, 128, 128, 0, 512, 512],
    [256, 128, 256, 128, 0, 0, 0, 512],
    [128, 256, 128, 0, 0, 0, 0, 0],
    [128, 128, 0, 128, 0, 0, 0, 128],
    [128, 0, 0, 0, 128, 0, 128, 128],
    [0, 0, 0, 0, 0, 128, 256, 128],
    [512, 0, 0, 0, 128, 256, 128, 256],
    [512, 512, 0, 128, 0, 128, 256, 128]
  ],
  "boards": [
    [0, 0, 0, 0, 0, 0, 0, 0],
    [0, 0, 0, 0, 0, 0, 0, 0],
    [0, 0, 0, 0, 0, 0, 0, 0],
    [0, 0, 0, 0, 0, 0, 0, 0],
    [0, 0, 0, 0, 0, 0, 0, 0],
    [0, 0, 0, 0, 0, 0, 0, 0],
    [0, 0, 0, 0, 0, 0, 0, 0],
    [0, 0, 0, 0, 0, 0, 0, 0]
  ],
  "goals": {
"ice": 24,
"web": 8
  }
}
