{
  "number": 10,
  "row": 8,
  "col": 8,
  "color": 5,
  "level": [
    [15, 0, 0, 0, 0, 0, 512, 512],
    [15, 15, 0, 0, 0, 0, 0, 512],
    [0, 15, 15, 0, 0, 0, 0, 0],
    [0, 0, 15, 15, 0, 0, 0, 0],
    [0, 0, 0, 15, 15, 0, 0, 0],
    [0, 0, 0, 0, 15, 15, 0, 0],
    [512, 0, 0, 0, 0, 15, 15, 0],
    [512, 512, 0, 0, 0, 0, 15, 15]
  ],
  "boards": [
    [0, 0, 0, 0, 0, 0, 0, 0],
    [0, 0, 0, 0, 0, 0, 0, 0],
    [1, 0, 0, 0, 0, 0, 0, 0],
    [1, 1, 0, 0, 0, 0, 0, 0],
    [1, 1, 1, 0, 0, 0, 0, 0],
    [1, 1, 1, 1, 0, 0, 0, 0],
    [0, 1, 1, 1, 1, 0, 0, 0],
    [0, 0, 1, 1, 1, 1, 0, 0]
  ],
  "goals": {
"board": 18,
    "stone": 15
  }
}
