{
  "number": 45,
  "row": 8,
  "col": 8,
  "color": 5,
  "level": [
    [0, 0, 0, 0, 0, 0, 0, 0],
    [128, 128, 128, 0, 0, 0, 128, 128],
    [15, 15, 128, 0, 0, 128, 15, 15],
    [14, 15, 128, 0, 0, 128, 15, 14],
    [0, 15, 128, 0, 0, 128, 15, 0],
    [15, 15, 128, 0, 0, 128, 15, 15],
    [128, 128, 128, 128, 0, 0, 128, 128],
    [0, 0, 0, 0, 0, 0, 0, 0]
  ],
  "boards": [
    [0, 0, 0, 0, 0, 0, 0, 0],
    [0, 0, 0, 0, 0, 0, 0, 0],
    [0, 0, 0, 0, 0, 0, 0, 0],
    [0, 0, 0, 0, 0, 0, 0, 0],
    [0, 0, 0, 0, 0, 0, 0, 0],
    [0, 0, 0, 0, 0, 0, 0, 0],
    [0, 0, 0, 0, 0, 0, 0, 0],
    [0, 0, 0, 0, 0, 0, 0, 0]
  ],
  "goals": {
"ice": 20,
"stone": 12
  }
}
