{
  "number": 51,
  "row": 8,
  "col": 8,
  "color": 5,
  "level": [
    [0, 0, 0, 0, 15, 128, 128, 128],
    [0, 0, 0, 0, 0, 15, 128, 128],
    [0, 0, 0, 0, 0, 0, 15, 128],
    [0, 0, 0, 0, 0, 0, 0, 15],
    [15, 0, 0, 0, 0, 0, 0, 0],
    [128, 15, 0, 0, 0, 0, 0, 0],
    [128, 128, 15, 0, 0, 0, 0, 0],
    [128, 128, 128, 15, 0, 0, 0, 0]
  ],
  "boards": [
    [1, 1, 0, 0, 0, 0, 0, 0],
    [1, 1, 1, 0, 0, 0, 0, 0],
    [0, 1, 1, 1, 0, 0, 0, 0],
    [0, 0, 1, 1, 1, 0, 0, 0],
    [0, 0, 0, 1, 1, 1, 0, 0],
    [0, 0, 0, 0, 1, 1, 1, 0],
    [0, 0, 0, 0, 0, 1, 1, 1],
    [0, 0, 0, 0, 0, 0, 1, 1]
  ],
  "goals": {
"board": 22,
"ice": 12
  }
}
