{
  "number": 43,
  "row": 8,
  "col": 8,
  "color": 5,
  "level": [
    [0, 0, 0, 512, 512, 0, 0, 0],
    [0, 0, 0, 512, 512, 0, 0, 0],
    [128, 0, 0, 512, 512, 0, 0, 128],
    [128, 128, 0, 0, 0, 0, 128, 128],
    [128, 128, 0, 0, 0, 0, 128, 128],
    [128, 128, 0, 0, 0, 0, 128, 128],
    [128, 0, 0, 0, 0, 0, 0, 128],
    [0, 0, 0, 0, 0, 0, 0, 0]
  ],
  "boards": [
    [0, 0, 0, 0, 0, 0, 0, 0],
    [0, 0, 0, 0, 0, 0, 0, 0],
    [0, 0, 0, 0, 0, 0, 0, 0],
    [0, 0, 0, 0, 0, 0, 0, 0],
    [0, 0, 0, 0, 0, 0, 0, 0],
    [0, 0, 0, 0, 0, 0, 0, 0],
    [0, 1, 1, 1, 1, 1, 1, 0],
    [1, 1, 1, 1, 1, 1, 1, 1]
  ],
  "goals": {
"board": 14,
"ice": 16
  }
}
