
{
  "row": 8,
  "col": 8,
  "color": 7,
  "level": [
    [512, 512, 2, 5, 5, 14, 512, 512],
    [512,   3, 5, 4, 2, 3, 4,   512],
    [1,     2, 15, 15, 15, 15, 3,     5],
    [2,    6, 15, 512, 512, 15, 4,    4],
    [3,    3, 15, 512, 512, 15, 1,    3],
    [1,     2, 15, 15, 15, 15, 5,     4],
    [512,   6, 5, 3, 4, 4, 6,   512],
    [512, 512, 5, 4, 5, 4, 512, 512]
  ],
  "boards": [
    [0, 0, 0, 0, 0, 0, 0, 0],
    [0, 1, 1, 1, 1, 1, 1, 0],
    [0, 1, 0, 0, 0, 0, 1, 0],
    [0, 1, 0, 0, 0, 0, 1, 0],
    [0, 1, 0, 0, 0, 0, 1, 0],
    [0, 1, 0, 0, 0, 0, 1, 0],
    [0, 1, 1, 1, 1, 1, 1, 0],
    [0, 0, 0, 0, 0, 0, 0, 0]
  ]
}
