{
  "number": 47,
  "row": 8,
  "col": 8,
  "color": 5,
  "level": [
    [512, 512, 512, 0, 0, 512, 512, 512],
    [512, 512, 0, 0, 0, 0, 512, 512],
    [512, 0, 0, 0, 0, 0, 0, 512],
    [0, 0, 0, 256, 256, 0, 0, 0],
    [0, 0, 256, 128, 128, 256, 0, 0],
    [0, 0, 256, 128, 128, 256, 0, 0],
    [0, 256, 128, 128, 128, 128, 256, 0],
    [256, 128, 128, 128, 128, 128, 128, 256]
  ],
  "boards": [
    [0, 0, 0, 0, 0, 0, 0, 0],
    [0, 0, 0, 0, 0, 0, 0, 0],
    [0, 0, 0, 0, 0, 0, 0, 0],
    [0, 0, 0, 0, 0, 0, 0, 0],
    [0, 0, 0, 0, 0, 0, 0, 0],
    [0, 0, 0, 0, 0, 0, 0, 0],
    [0, 0, 0, 0, 0, 0, 0, 0],
    [0, 0, 0, 0, 0, 0, 0, 0]
  ],
  "goals": {
"ice": 14,
"web": 10
  }
}
