{
  "row": 8,
  "col": 8,
  "color": 2,
  "level": [
    [1, 2, 2, 5, 4, 1, 5, 4],
    [3, 7, 1, 4, 5, 6, 1, 2],
    [2, 1, 3, 3, 1, 3, 3, 1],
    [5, 6, 6, 1, 2, 4, 4, 6],
    [2, 1, 3, 3, 2, 4, 3, 1],
    [15, 15, 15, 15, 15, 15, 15, 15],
    [512, 512, 512, 512, 512, 512, 512, 512],
    [512, 512, 512, 512, 512, 512, 512, 512]
  ],
  "boards": [
    [0, 0, 0, 0, 0, 0, 0, 0],
    [0, 0, 0, 0, 0, 0, 0, 0],
    [0, 0, 0, 0, 0, 0, 0, 0],
    [0, 0, 0, 0, 0, 0, 0, 0],
    [0, 0, 0, 0, 0, 0, 0, 0],
    [0, 0, 0, 0, 0, 0, 0, 0],
    [0, 0, 0, 0, 0, 0, 0, 0],
    [0, 0, 0, 0, 0, 0, 0, 0]
  ]
}
