{
  "row": 8,
  "col": 8,
  "color": 5,
  "level": [
    [512, 15, 0, 0, 0, 0, 15, 512],
    [15, 15, 0, 0, 0, 0, 15, 15],
    [0, 0, 0, 0, 0, 0, 0, 0],
    [0, 0, 0, 0, 0, 0, 0, 0],
    [0, 0, 0, 0, 0, 0, 0, 0],
    [0, 0, 0, 0, 0, 0, 0, 0],
    [15, 15, 0, 0, 0, 0, 15, 15],
    [512, 15, 0, 0, 0, 0, 15, 512]
  ],
  "boards": [
    [0, 0, 1, 0, 0, 1, 0, 0],
    [0, 0, 1, 0, 0, 1, 0, 0],
    [1, 1, 1, 0, 0, 1, 1, 1],
    [0, 0, 0, 1, 1, 0, 0, 0],
    [0, 0, 0, 1, 1, 0, 0, 0],
    [1, 1, 1, 0, 0, 1, 1, 1],
    [0, 0, 1, 0, 0, 1, 0, 0],
    [0, 0, 1, 0, 0, 1, 0, 0]
  ]
}
