{
  "row": 8,
  "col": 8,
  "color": 7,
  "level": [
    [512,    2, 2, 5, 4, 1, 5,    512],
    [512,    7, 1, 4, 5, 6, 1,    512],
    [512,    1, 3, 3, 2, 4, 3,    512],
    [512,    6, 6, 1, 2, 4, 4,    512],
    [512,    512, 512, 512, 512, 512, 512,    512],
    [512,     512, 512, 512, 512, 512, 512,     512],
    [512,   512, 512, 512, 512, 512, 512,   512],
    [512, 512, 512, 512, 512, 512, 512, 512]
  ],
  "boards": [
    [0, 0, 0, 0, 0, 0, 0, 0],
    [0, 0, 0, 0, 0, 0, 0, 0],
    [0, 0, 0, 0, 0, 0, 0, 0],
    [0, 0, 0, 0, 0, 0, 0, 0],
    [0, 0, 0, 0, 0, 0, 0, 0],
    [0, 0, 0, 0, 0, 0, 0, 0],
    [0, 0, 0, 0, 0, 0, 0, 0],
    [0, 0, 0, 0, 0, 0, 0, 0]
  ]
}
