{
  "number": 33,
  "row": 8,
  "col": 8,
  "color": 5,
  "level": [
    [512, 512, 0, 0, 0, 0, 512, 512],
    [512, 0, 0, 0, 0, 0, 0, 512],
    [0, 0, 15, 15, 15, 15, 0, 0],
    [0, 0, 15, 0, 0, 15, 0, 0],
    [0, 0, 15, 0, 0, 15, 0, 0],
    [0, 0, 15, 15, 15, 15, 0, 0],
    [512, 0, 0, 0, 0, 0, 0, 512],
    [512, 512, 0, 0, 0, 0, 512, 512]
  ],
  "boards": [
    [0, 0, 0, 0, 0, 0, 0, 0],
    [0, 0, 0, 0, 0, 0, 0, 0],
    [0, 0, 0, 0, 0, 0, 0, 0],
    [0, 0, 0, 0, 0, 0, 0, 0],
    [0, 0, 0, 0, 0, 0, 0, 0],
    [0, 0, 0, 0, 0, 0, 0, 0],
    [0, 0, 0, 0, 0, 0, 0, 0],
    [0, 0, 0, 0, 0, 0, 0, 0]
  ],
  "spider": [
    [3, 3],
    [3, 4],
    [4, 4],
    [4, 3]
    

],
  "goals": {
"stone": 12
  }
}
