{
  "row": 8,
  "col": 8,
  "color": 6,
  "level": [
    [0, 0, 0, 0, 0, 0, 0, 0],
    [0, 0, 0, 0, 0, 0, 0, 0],
    [0, 0, 0, 0, 0, 0, 0, 0],
    [0, 0, 0, 0, 0, 0, 0, 0],
    [0, 0, 0, 0, 0, 0, 0, 0],
    [0, 0, 0, 0, 0, 0, 0, 0],
    [0, 0, 0, 0, 0, 0, 0, 0],
    [0, 0, 0, 0, 0, 0, 0, 0]
  ],
  "boards": [
    [1, 1, 1, 0, 0, 1, 1, 1],
    [1, 1, 1, 0, 0, 1, 1, 1],
    [1, 1, 1, 1, 1, 1, 1, 1],
    [0, 0, 1, 0, 0, 1, 0, 0],
    [0, 0, 1, 0, 0, 1, 0, 0],
    [1, 1, 1, 1, 1, 1, 1, 1],
    [1, 1, 1, 0, 0, 1, 1, 1],
    [1, 1, 1, 0, 0, 1, 1, 1]
  ],
  "goals": {
"board": 44
  }
}
