{
  "number": 6,
  "row": 8,
  "col": 8,
  "color": 6,
  "level": [
    [0, 0, 0, 0, 0, 0, 0, 0],
    [0, 0, 0, 0, 0, 0, 0, 0],
    [0, 0, 0, 0, 0, 0, 0, 0],
    [0, 0, 0, 512, 512, 0, 0, 0],
    [0, 0, 0, 512, 512, 0, 0, 0],
    [0, 0, 0, 0, 0, 0, 0, 0],
    [0, 0, 0, 0, 0, 0, 0, 0],
    [0, 0, 0, 0, 0, 0, 0, 0]
  ],
  "boards": [
    [0, 0, 0, 0, 0, 0, 0, 0],
    [0, 0, 0, 0, 0, 0, 0, 0],
    [0, 0, 1, 1, 1, 1, 0, 0],
    [1, 1, 1, 0, 0, 1, 1, 1],
    [1, 1, 1, 0, 0, 1, 1, 1],
    [0, 0, 1, 1, 1, 1, 0, 0],
    [0, 0, 0, 0, 0, 0, 0, 0],
    [0, 0, 0, 0, 0, 0, 0, 0]
  ],
  "goals": {
"board": 20
  }
}
