{
  "number": 1,
  "row": 8,
  "col": 8,
  "color": 5,
  "level": [
    [0, 0, 0, 0, 0, 0, 0, 0],
    [0, 0, 0, 0, 0, 0, 0, 0],
    [15, 15, 15, 0, 0, 15, 15, 15],
    [256, 256, 256, 0, 0, 256, 256, 256],
    [256, 256, 256, 0, 0, 256, 256, 256],
    [256, 256, 256, 0, 0, 256, 256, 256],
    [256, 256, 256, 0, 0, 256, 256, 256],
    [256, 256, 256, 0, 0, 256, 256, 256]
  ],
  "boards": [
    [0, 0, 0, 0, 0, 0, 0, 0],
    [0, 0, 0, 0, 0, 0, 0, 0],
    [0, 0, 0, 0, 0, 0, 0, 0],
    [0, 0, 0, 0, 0, 0, 0, 0],
    [0, 0, 0, 0, 0, 0, 0, 0],
    [0, 0, 0, 0, 0, 0, 0, 0],
    [0, 0, 0, 0, 0, 0, 0, 0],
    [0, 0, 0, 0, 0, 0, 0, 0]
  ],
  "goals": {
"3": 24,
"4": 24
  }
}
