{
  "number": 44,
  "row": 8,
  "col": 8,
  "color": 5,
  "level": [
    [0, 0, 0, 0, 0, 0, 0, 0],
    [0, 0, 15, 15, 15, 15, 0, 0],
    [0, 0, 15, 128, 128, 15, 0, 0],
    [0, 0, 15, 128, 128, 15, 0, 0],
    [0, 0, 15, 128, 128, 15, 0, 0],
    [0, 0, 15, 128, 128, 15, 0, 0],
    [0, 0, 15, 15, 15, 15, 0, 0],
    [0, 0, 0, 0, 0, 0, 0, 0]
  ],
  "boards": [
    [0, 0, 0, 0, 0, 0, 0, 0],
    [0, 0, 0, 0, 0, 0, 0, 0],
    [0, 0, 0, 0, 0, 0, 0, 0],
    [0, 0, 0, 0, 0, 0, 0, 0],
    [0, 0, 0, 0, 0, 0, 0, 0],
    [0, 0, 0, 0, 0, 0, 0, 0],
    [0, 0, 0, 0, 0, 0, 0, 0],
    [0, 0, 0, 0, 0, 0, 0, 0]
  ],
  "goals": {
"ice": 8,
"stone": 16
  }
}
