{
  "row": 8,
  "col": 8,
  "color": 5,
  "level": [
    [0, 14, 0, 14, 0, 14, 0, 14],
    [0, 0, 0, 0, 0, 0, 0, 0],
    [0, 0, 0, 0, 0, 0, 0, 0],
    [0, 0, 0, 0, 0, 0, 0, 0],
    [0, 0, 0, 0, 0, 0, 0, 0],
    [0, 0, 0, 0, 0, 0, 0, 0],
    [0, 0, 0, 0, 0, 0, 0, 0],
    [0, 0, 0, 0, 0, 0, 0, 0]
  ],
  "boards": [
    [1, 0, 1, 0, 1, 0, 1, 0],
    [0, 1, 0, 1, 0, 1, 0, 1],
    [0, 1, 0, 1, 0, 1, 0, 1],
    [0, 1, 0, 1, 0, 1, 0, 1],
    [0, 1, 0, 1, 0, 1, 0, 1],
    [0, 1, 0, 1, 0, 1, 0, 1],
    [0, 1, 0, 1, 0, 1, 0, 1],
    [0, 1, 0, 1, 0, 1, 0, 1]
  ]
}
