{
  "number": 12,
  "row": 8,
  "col": 8,
  "color": 5,
  "level": [
    [512, 512, 14, 0, 0, 14, 512, 512],
    [512, 0, 0, 0, 0, 0, 0, 512],
    [512, 0, 0, 0, 0, 0, 0, 512],
    [512, 0, 0, 0, 0, 0, 0, 512],
    [512, 0, 0, 0, 0, 0, 0, 512],
    [512, 0, 0, 0, 0, 0, 0, 512],
    [512, 0, 0, 0, 0, 0, 0, 512],
    [512 0, 0, 0, 0, 0, 0, 512]
  ],
  "boards": [
    [0, 0, 0, 0, 0, 0, 0, 0],
    [0, 0, 0, 0, 0, 0, 0, 0],
    [0, 0, 0, 0, 0, 0, 0, 0],
    [0, 0, 0, 0, 0, 0, 0, 0],
    [0, 0, 0, 0, 0, 0, 0, 0],
    [0, 0, 0, 0, 0, 0, 0, 0],
    [0, 0, 0, 0, 0, 0, 0, 0],
    [0, 0, 0, 0, 0, 0, 0, 0]
  ],
  "goals": {
"acorn": 2
  }
}
