{
  "number": 48,
  "row": 8,
  "col": 8,
  "color": 5,
  "level": [
    [128, 0, 0, 0, 0, 128, 128, 128],
    [128, 128, 0, 0, 0, 0, 128, 128],
    [128, 128, 128, 0, 0, 0, 0, 128],
    [128, 128, 128, 128, 0, 0, 0, 0],
    [128, 128, 128, 128, 128, 0, 0, 0],
    [128, 128, 128, 128, 128, 128, 0, 0],
    [128, 128, 128, 128, 128, 128, 128, 0],
    [128, 128, 128, 128, 128, 128, 128, 128]
  ],
  "boards": [
    [0, 0, 0, 0, 0, 0, 0, 0],
    [0, 0, 0, 0, 0, 0, 0, 0],
    [0, 0, 0, 0, 0, 0, 0, 0],
    [0, 0, 0, 0, 0, 0, 0, 0],
    [0, 0, 0, 0, 0, 0, 0, 0],
    [0, 0, 0, 0, 0, 0, 0, 0],
    [0, 0, 0, 0, 0, 0, 0, 0],
    [0, 0, 0, 0, 0, 0, 0, 0]
  ],
  "goals": {
"ice": 42
  }
}
