{
  "row": 8,
  "col": 8,
  "color": 5,
  "level": [
    [0, 0, 0, 0, 0, 0, 0, 0],
    [0, 0, 0, 0, 0, 0, 0, 0],
    [0, 0, 0, 0, 0, 0, 0, 0],
    [15, 15, 0, 0, 0, 0, 15, 15],
    [15, 15, 0, 15, 15, 0, 15, 15],
    [15, 15, 0, 15, 15, 0, 15, 15],
    [15, 15, 15, 15, 15, 15, 15, 15],
    [15, 15, 15, 15, 15, 15, 15, 15]
  ],
  "boards": [
    [1, 1, 1, 1, 1, 1, 1, 1],
    [1, 1, 1, 1, 1, 1, 1, 1],
    [1, 1, 1, 1, 1, 1, 1, 1],
    [1, 1, 1, 1, 1, 1, 1, 1],
    [1, 1, 1, 1, 1, 1, 1, 1],
    [1, 1, 1, 1, 1, 1, 1, 1],
    [1, 1, 1, 1, 1, 1, 1, 1],
    [1, 1, 1, 1, 1, 1, 1, 1]
  ],
  "goals": {
"board": 64,
"stone": 32
  }
}
