{
  "row": 5,
  "col": 8,
  "color": 5,
  "level": [
    [512, 0, 0, 14, 14, 0, 0, 512],
    [512, 0, 0, 0, 0, 0, 0, 512],
    [512, 0, 0, 0, 0, 0, 0, 512],
    [512, 0, 0, 0, 0, 0, 0, 512],
    [512, 0, 0, 0, 0, 0, 0, 512],
    [512, 0, 0, 0, 0, 0, 0, 512],
    [512, 0, 0, 0, 0, 0, 0, 512],
    [512, 0, 0, 0, 0, 0, 0, 512]
  ],
  "boards": [
    [0, 0, 0, 0, 0, 0, 0, 0],
    [0, 0, 0, 0, 0, 0, 0, 0],
    [0, 0, 0, 0, 0, 0, 0, 0],
    [0, 0, 0, 0, 0, 0, 0, 0],
    [0, 0, 0, 0, 0, 0, 0, 0],
    [0, 0, 0, 0, 0, 0, 0, 0],
    [0, 0, 0, 0, 0, 0, 0, 0],
    [0, 0, 0, 0, 0, 0, 0, 0]
  ]
}
