{
  "row": 8,
  "col": 8,
  "color": 5,
  "level": [
    [0, 0, 0, 0, 0, 0, 14, 15],
    [0, 0, 0, 0, 0, 0, 15, 1024],
    [0, 0, 0, 0, 0, 15, 1024, 1024],
    [0, 0, 0, 0, 15, 1024, 1024, 1024],
    [0, 0, 0, 15, 1024, 1024, 1024, 1024],
    [0, 0, 15, 1024, 1024, 1024, 1024, 1024],
    [0, 15, 1024, 1024, 1024, 1024, 1024, 1024],
    [15, 1024, 1024, 1024, 1024, 1024, 1024, 1024]
  ],
  "boards": [
    [0, 0, 0, 0, 0, 0, 0, 0],
    [0, 0, 0, 0, 0, 0, 0, 1],
    [0, 0, 0, 0, 0, 0, 1, 1],
    [0, 0, 0, 0, 0, 1, 1, 1],
    [0, 0, 0, 0, 1, 1, 1, 1],
    [0, 0, 0, 1, 1, 1, 1, 1],
    [0, 0, 1, 1, 1, 1, 1, 1],
    [0, 1, 1, 1, 1, 1, 1, 1]
  ],
  "goals": {
"board": 28,
"acorn": 1
  }
}
