{
  "row": 8,
  "col": 8,
  "color": 6,
  "level": [
    [512, 0, 14, 0, 0, 14, 0, 512],
    [512, 0, 0, 0, 0, 0, 0, 512],
    [512, 0, 0, 0, 0, 0, 0, 512],
    [512, 0, 0, 0, 0, 0, 0, 512],
    [512, 0, 0, 0, 0, 0, 0, 512],
    [512, 0, 0, 0, 0, 0, 0, 512],
    [512, 0, 0, 0, 0, 0, 0, 512],
    [512, 0, 0, 0, 0, 0, 0, 512]
  ],
  "boards": [
    [0, 1, 0, 1, 1, 0, 1, 0],
    [0, 1, 0, 1, 1, 0, 1, 0],
    [0, 1, 0, 1, 1, 0, 1, 0],
    [0, 1, 0, 1, 1, 0, 1, 0],
    [0, 1, 0, 1, 1, 0, 1, 0],
    [0, 1, 0, 1, 1, 0, 1, 0],
    [0, 1, 0, 1, 1, 0, 1, 0],
    [0, 1, 0, 1, 1, 0, 1, 0]
  ]
}
