{
  "number": 53,
  "row": 8,
  "col": 8,
  "color": 5,
  "level": [
    [0, 0, 0, 512, 512, 512, 0, 0],
    [0, 0, 0, 0, 512, 0, 0, 0],
    [15, 0, 0, 0, 0, 0, 0, 0],
    [128, 15, 0, 0, 0, 0, 0, 15],
    [15, 128, 15, 0, 0, 0, 15, 128],
    [128, 15, 128, 15, 0, 15, 128, 15],
    [15, 128, 15, 128, 15, 128, 15, 128],
    [128, 15, 128, 15, 128, 15, 128, 15]
  ],
  "boards": [
    [0, 0, 0, 0, 0, 0, 0, 0],
    [0, 0, 0, 0, 0, 0, 0, 0],
    [0, 0, 0, 0, 0, 0, 0, 0],
    [0, 0, 0, 0, 0, 0, 0, 0],
    [0, 0, 0, 0, 0, 0, 0, 0],
    [0, 0, 0, 0, 0, 0, 0, 0],
    [0, 0, 0, 0, 0, 0, 0, 0],
    [0, 0, 0, 0, 0, 0, 0, 0]
  ],
  "goals": {
"ice": 15,
"stone": 18
  }
}
