{
  "number": 29,
  "row": 8,
  "col": 8,
  "color": 5,
  "level": [
    [15, 15, 256, 0, 0, 0, 512, 512],
    [15, 15, 256, 256, 0, 0, 0, 512],
    [256, 256, 15, 15, 0, 0, 0, 0],
    [0, 256, 15, 15, 256, 256, 0, 0],
    [0, 0, 256, 256, 15, 15, 256, 0],
    [0, 0, 0, 256, 15, 15, 256, 256],
    [512, 0, 0, 0, 256, 256, 15, 15],
    [512, 512, 0, 0, 0, 256, 15, 15]
  ],
  "boards": [
    [1, 1, 0, 0, 0, 0, 0, 0],
    [0, 1, 0, 0, 0, 0, 0, 0],
    [0, 0, 1, 1, 0, 0, 0, 0],
    [0, 0, 1, 1, 0, 0, 0, 0],
    [0, 0, 0, 0, 1, 1, 0, 0],
    [0, 0, 0, 0, 1, 1, 0, 0],
    [0, 0, 0, 0, 0, 0, 1, 1],
    [0, 0, 0, 0, 0, 0, 1, 1]
  ],
  "goals": {
"board": 16
  }
}
