{
  "number": 46,
  "row": 8,
  "col": 8,
  "color": 5,
  "level": [
    [0, 0, 14, 0, 0, 14, 0, 0],
    [0, 0, 0, 0, 0, 0, 0, 0],
    [512, 0, 0, 0, 0, 0, 0, 512],
    [512, 0, 128, 128, 128, 128, 0, 512],
    [512, 0, 128, 0, 0, 128, 0, 512],
    [128, 128, 128, 0, 0, 128, 128, 128],
    [128, 128, 0, 0, 0, 0, 128, 128],
    [128, 128, 0, 0, 0, 0, 128, 128]
  ],
  "boards": [
    [0, 0, 0, 0, 0, 0, 0, 0],
    [0, 0, 0, 0, 0, 0, 0, 0],
    [0, 0, 0, 0, 0, 0, 0, 0],
    [0, 0, 0, 0, 0, 0, 0, 0],
    [0, 0, 0, 1, 1, 0, 0, 0],
    [0, 0, 0, 1, 1, 0, 0, 0],
    [0, 0, 1, 1, 1, 1, 0, 0],
    [0, 0, 1, 1, 1, 1, 0, 0]
  ],
  "goals": {
"board": 12,
"acorn": 2
  }
}
