{
  "row": 8,
  "col": 8,
  "color": 5,
  "level": [
    [0, 0, 15, 0, 0, 15, 0, 0],
    [0, 0, 15, 0, 0, 15, 0, 0],
    [0, 0, 15, 0, 0, 15, 0, 0],
    [0, 0, 15, 0, 0, 15, 0, 0],
    [0, 0, 15, 0, 0, 15, 0, 0],
    [0, 0, 15, 0, 0, 15, 0, 0],
    [0, 0, 15, 0, 0, 15, 0, 0],
    [0, 0, 15, 0, 0, 15, 0, 0]
  ],
  "boards": [
    [0, 0, 0, 0, 0, 0, 0, 0],
    [0, 0, 0, 0, 0, 0, 0, 0],
    [0, 0, 0, 0, 0, 0, 0, 0],
    [0, 0, 0, 0, 0, 0, 0, 0],
    [0, 0, 0, 0, 0, 0, 0, 0],
    [0, 0, 0, 0, 0, 0, 0, 0],
    [0, 0, 0, 0, 0, 0, 0, 0],
    [0, 0, 0, 0, 0, 0, 0, 0]
  ]
}
