{
  "number": 20,
  "row": 8,
  "col": 8,
  "color": 5,
  "level": [
    [0, 0, 14, 512, 512, 14, 0, 0],
    [0, 0, 0, 0, 0, 0, 0, 0],
    [0, 0, 0, 0, 0, 0, 0, 0],
    [512, 0, 0, 0, 0, 0, 0, 512],
    [512, 0, 0, 0, 0, 0, 0, 512],
    [0, 0, 0, 0, 0, 0, 0, 0],
    [0, 0, 0, 0, 0, 0, 0, 0],
[0, 0, 0, 0, 0, 0, 0, 0]
  ],
  "boards": [
    [0, 0, 0, 0, 0, 0, 0, 0],
    [0, 0, 0, 0, 0, 0, 0, 0],
    [0, 0, 0, 0, 0, 0, 0, 0],
    [0, 0, 0, 0, 0, 0, 0, 0],
    [0, 0, 0, 0, 0, 0, 0, 0],
    [1, 0, 0, 0, 0, 0, 0, 1],
    [1, 0, 1, 1, 1, 1, 0, 1],
    [1, 1, 1, 1, 1, 1, 1, 1]
  ],
  "goals": {
"acorn": 2,
 "board":16
  }
}
