{
  "row": 8,
  "col": 8,
  "color": 5,
  "level": [
    [0, 0, 0, 0, 0, 0, 0, 0],
    [0, 0, 0, 0, 0, 0, 0, 0],
    [0, 0, 0, 0, 0, 0, 0, 0],
    [0, 0, 0, 0, 0, 0, 0, 0],
    [15, 15, 15, 15, 15, 15, 15, 15],
    [0, 0, 0, 15, 15, 0, 0, 0],
    [0, 0, 0, 15, 15, 0, 0, 0],
    [0, 0, 0, 15, 15, 0, 0, 0]
  ],
  "boards": [
    [0, 0, 0, 0, 0, 0, 0, 0],
    [0, 0, 0, 0, 0, 0, 0, 0],
    [0, 0, 0, 0, 0, 0, 0, 0],
    [0, 0, 0, 0, 0, 0, 0, 0],
    [0, 0, 0, 0, 0, 0, 0, 0],
    [1, 1, 1, 0, 0, 1, 1, 1],
    [1, 1, 1, 0, 0, 1, 1, 1],
    [1, 1, 1, 0, 0, 1, 1, 1]
  ],
  "goals": {
"board": 18,
    "stone": 14
  }
}
