{
  "number": 21,
  "row": 8,
  "col": 8,
  "color": 5,
  "level": [
    [0, 0, 0, 256, 0, 0, 0, 0],
    [0, 0, 256, 0, 0, 0, 0, 256],
    [0, 256, 0, 0, 0, 0, 256, 0],
    [256, 0, 0, 0, 0, 256, 0, 0],
    [0, 0, 0, 0, 256, 0, 0, 0],
    [512, 512, 512, 512, 512, 512, 512, 512],
    [512, 512, 512, 512, 512, 512, 512, 512],
    [512, 512, 512, 512, 512, 512, 512, 512]
  ],
  "boards": [
    [0, 0, 0, 0, 0, 0, 0, 0],
    [0, 0, 0, 0, 0, 0, 0, 0],
    [0, 0, 0, 0, 0, 0, 0, 0],
    [0, 0, 0, 0, 0, 0, 0, 0],
    [0, 0, 0, 0, 0, 0, 0, 0],
    [0, 0, 0, 0, 0, 0, 0, 0],
    [0, 0, 0, 0, 0, 0, 0, 0],
    [0, 0, 0, 0, 0, 0, 0, 0]
  ],
  "goals": {
"2": 14
  }
}
