{
  "row": 8,
  "col": 8,
  "color": 6,
  "level": [
    [512, 0, 0, 0, 0, 0, 0, 512],
    [512, 0, 0, 0, 0, 0, 0, 512],
    [512, 0, 0, 0, 0, 0, 0, 512],
    [512, 0, 0, 0, 0, 0, 0, 512],
    [512, 512, 512, 512, 512, 512, 512, 512],
    [512, 512, 512, 512, 512, 512, 512, 512],
    [512, 512, 512, 512, 512, 512, 512, 512],
    [512, 512, 512, 512, 512, 512, 512, 512]
  ],
  "boards": [
    [0, 0, 0, 0, 0, 0, 0, 0],
    [0, 0, 0, 0, 0, 0, 0, 0],
    [0, 0, 0, 0, 0, 0, 0, 0],
    [0, 0, 0, 0, 0, 0, 0, 0],
    [0, 0, 0, 0, 0, 0, 0, 0],
    [0, 0, 0, 0, 0, 0, 0, 0],
    [0, 0, 0, 0, 0, 0, 0, 0],
    [0, 0, 0, 0, 0, 0, 0, 0]
  ]
}
