{
  "number": 11,
  "row": 8,
  "col": 8,
  "color": 5,
  "level": [
    [512, 512, 512, 0, 0, 0, 0, 0],
    [512, 512, 0, 0, 0, 512, 512, 0],
    [512, 0, 0, 0, 0, 0, 512, 0],
    [0, 0, 0, 15, 15, 0, 0, 0],
    [0, 0, 0, 15, 15, 0, 0, 0],
    [0, 512, 0, 0, 0, 0, 0, 512],
    [0, 512, 512, 0, 0, 0, 512, 512],
    [0, 0, 0, 0, 0, 512, 512, 512]
  ],
  "boards": [
    [0, 0, 0, 0, 0, 0, 0, 0],
    [0, 0, 0, 0, 1, 0, 0, 0],
    [0, 0, 0, 0, 1, 1, 0, 0],
    [0, 0, 0, 0, 0, 1, 1, 0],
    [0, 1, 1, 0, 0, 0, 0, 0],
    [0, 0, 1, 1, 0, 0, 0, 0],
    [0, 0, 0, 1, 0, 0, 0, 0],
    [0, 0, 0, 0, 0, 0, 0, 0]
  ],
  "goals": {
"stone": 4,
    "board": 10
  }
}
