{
  "number": 26,
  "row": 8,
  "col": 8,
  "color": 5,
  "level": [
    [512, 14, 256, 0, 0, 256, 14, 512],
    [512, 0, 256, 0, 0, 256, 256, 512],
    [0, 0, 0, 0, 0, 0, 0, 0],
    [0, 0, 0, 0, 0, 0, 0, 0],
    [0, 0, 0, 0, 0, 0, 0, 0],
    [0, 0, 0, 0, 0, 0, 0, 0],
    [15, 15, 15, 512, 512, 15, 15, 15],
    [15, 15, 15, 512, 512, 15, 15, 15]
  ],
  "boards": [
    [0, 0, 0, 0, 0, 0, 0, 0],
    [0, 0, 0, 0, 0, 0, 0, 0],
    [0, 0, 0, 0, 0, 0, 0, 0],
    [0, 0, 0, 0, 0, 0, 0, 0],
    [0, 0, 0, 0, 0, 0, 0, 0],
    [0, 0, 0, 0, 0, 0, 0, 0],
    [0, 0, 0, 0, 0, 0, 0, 0],
    [0, 0, 0, 0, 0, 0, 0, 0]
  ],
  "goals": {
"acorn": 2
  }
}
